   #######################
   #S    #     #         #
   ##### # ### # #########
   #   # # #   #       # #
   # # # # # ######### # #
   # # # # #         # # #
   # # # # ########### # #
   # #   #           # # #
 ### ############### # # #
 #   #             # # # #
 # ### ############# # # #
 #   #     #       # # # #
 ### ##### # ##### # # ###
   #     # #     # # #   #
 ### ### # ##### # # ### #
 #   # # # #   # # #   # #
 # ### # # # # ### ### # #
 #     #   # #   #   # # #
 ####### ### ### ### # # #
       #     #   #   # # #
 ############### ##### # #
               #     # # #
 ############### ### # # #
 #               # # # # #
 # ############### # # # #
 #           #     # # # #
 ########### # ##### # ###
           # #     #   #
 ########### ##### #####
           #     #     #
 ##################### #
                     #G#