##############
S #    #     #
# # ## # ### #
#   #  # #   #
### # ## # # #
#     #  # # #
# ##### ## # #
#     #    # #
##### ###### #
#          # #
# ######## # #
#        # # #
######## # # #
#      #   # G
##############