#############################
S     #       #     #       #
##### # ##### # ### # #######
#   # #     # # #   #       #
# # # ##### # # # ######### #
# # #     # # # #         # #
# # ##### # # # ######### # #
# #     # # # #         # # #
# ##### ### # ######### # # #
#     #     #         # # # #
##### ############### # # # #
#   #               # # # # #
# # # ############### # # # #
# # #           #     # # # #
# # ########### # ##### # # #
# #           # #     # # # #
# ########### ##### # ### # #
#           #     # #   # # #
########### ##### # ### # # #
#         #     # # # # # # #
# ####### ##### # # # # # # #
#       #     # # # # # # # #
####### ##### # # # # # # # #
#     #     # # # # # # #   #
# ### ##### # # # # # # #####
# #         # # # # # #     #
# ########### # # # # ##### #
#             # # # #     # #
############### # # ##### # #
#               # #     # # #
# ############### ##### # # #
#                     #   # G
#############################